20 20
WWWWWWWWWWWWWWWWWWWW
WS00a0000000A000000W
WWWWWWWWWWWWWWWWWW0W
W0000000B000000b000W
W0WWWWWWWWWWWWWWWWWW
W000000c000000C0000W
WWWWWWWWWWWWWWWWWW0W
W000000D000000d0000W
W0WWWWWWWWWWWWWWWWWW
W000000e000000E0000W
WWWWWWWWWWWWWWWWWW0W
W000000000000000000W
W0WWWWWWWWWWWWWWWWWW
W0W0000000000000000W
W0W0WWWWWWWWWWWWWW0W
W0W0W00000000000000W
W0W0W0WWWWWWWWWWWWWW
W0W0W0W0000G0000000W
W000W00000000000000W
WWWWWWWWWWWWWWWWWWWW