20 20
WWWWWWWWWWWWWWWWWWWW
W000000000a00000000W
W0WWWWWW00000WWWWWWW
W0W0000W00000W00000W
W0W0WW0WWWWWWW0WW00W
W0W0W00000000000W00W
W0W0W0WWWWWWWWW0W00W
W000W0W0000000W0W00W
WWWWW0W0WWW000W0WWWW
Wd0D00A0WGW000B00b0W
WWWWW0W0WEW000W0WWWW
W000W0W0000000W0W00W
W0e0W0WWWWWWWWW0W00W
W000W00000000000W00W
W000WW0WWWCWWW0WW00W
W000000W00000W00000W
WWWWWWWWS0c00WWWWWWW
W000000000000000000W
W000000000000000000W
WWWWWWWWWWWWWWWWWWWW