10 10
WWWWWWWWWW
W0000G000W
W00000000W
W00000000W
WWWWWAWWWW
W00000000W
W0000S000W
W0000000aW
W00000000W
WWWWWWWWWW